1-12-201
2-1-201
2-10-1
2-12-201
3-12-201
4-9-201
4-12-201
5-9-201
5-12-201
6-9-201
6-12-201
7-9-201
7-11-201
8-9-201
8-11-201
9-9-201
9-11-201
10-9-201
10-11-201
11-9-201
11-11-201
12-9-201
12-11-201
13-9-201
13-11-201
14-9-201
14-11-201
15-9-201
15-11-201
16-9-201
16-11-201
17-9-201
17-11-201
18-9-201
18-12-201
19-9-201
19-12-201
20-11-101
20-12-201
21-12-201
